###################################################
#S    # #     #     #     # #         # # #       #
##### # ### # ### # ### ### ####### # # # # # # # #
#         # # #   # #       #   # # #   # # # # # #
### ### ##### # ### ### ### # # # # ##### ### # ###
# #   #       # #         #   # #     # # #   #   #
# # # ### ### ######### ############# # # ####### #
#   #   #   # #       # #   # # # #   #     # # # #
####### ########### # # # ### # # ### # ### # # # #
#       # #       # #     #     #       #   # #   #
### # ### # # ########### ### ### ##### # ### # # #
#   #   # # #       #         # # #     #     # # #
# ####### # ### ##### # # ### # # # ######### # # #
#     #     # #   #   # # #     # # # #   # #   # #
# # ### ##### # # ##### ######### ### ### # # # ###
# #     #     # # #         #       # # #   # # # #
# ### ##### # # ### # ### ####### ### # ### ### # #
# #         # #     # #         #             #   #
### ############### ### ### # ##### ### ##### # ###
#       #             #   # #         #   #   #  E#
###################################################